Mayday, Mayday - your sight is extremly limited to only a few meters, you have to land the space ship as soon as possible. Loss of signal to your surrounding satellites will mean plane crash. You make your way down through massive ash clouds with flying rocks everywhere. Luckily you are able to land safely on planet Geysiria. A planet where no life exists.  Volcanoes, lava rocks, big waves, geysirs and deserted landcsape is what you find here. In order to leave this planet you need to bring the volcanoes to a standstill or find another way to leave this unpleasant planet. Good luck.

Your ship falls through thick layers of dark clouds. Red flashes illuminate your surroundings. The lights on your console warn you of the dangerously fast approaching energy level zero. As you finally break through the last cloud, you get a glimpse of what awaits you underneath. 
Black planes and sharp cliffs of a dark red shape the landscape. In the east you perceive a massive rock formation, in the west you see a thick blue stream cutting through the plane , illuminating big portions of it in the process. Somewhere to the south there seem to be some sort of industrial constructions, far in the north you believe to recognize cubic shapes that reveal a city. You don't have time to study the landscape much longer. All you concentration is desperately needed as you find a gap in the ghastly cliffs and bring down your ship. Heavy jolting, followed by a sudden blow signalize your landing. 
Your ship's on the ground, and you are too, barely. Welcome to Frizza.

On the Lookout
An Interactive Fiction by Daniel, Franziska, Tim, Kevin, Tobias
Release 1 / Serial number 170720 / Inform 7 build 6M62 (I6/v6.33 lib 6/12N) SD

Your arrival point. The Flat Rock
You arrive on a planet called Sitis. You think the landing went great but as you leave your spaceship, you realise that two of your three water container broke down. Without minimum one new watertank you can not continue your journey. Far away in the east you recognise some kind of different rooftops. Maybe someones living there who could help you?

You can see Teleportation Stone - Sitis, Teleportation Stone - Gaisetto, Teleportation Stone - Geysiria, Teleportation Stone - Frizza and Teleportation Stone - Kaldríss here.

>take frizza
Landing Zone
You step out of your ship onto a small square in the middle of nowhere. Your ship's dead and so is the computer. It seems like you ought to explore the environment. You remeber having seen civilization-like shapes to the south and to the north. To the east  there is a huge mountain, to the west there seems to be a Flux. You think you have seen something, or someone, moving on the mountain to the east, there might be people there.

You can see a Discharged Spaceship (in which is a Power Unit (empty)) here.

>x spaceship
Your spaceship, broken down due to power loss. The clouds in the atmosphere may have sped up the discharge.

In the Discharged Spaceship is a Power Unit.

>x power unit
The Power Unit is empty.

>go sw
You don't want to go there.

>w
Flux
A viscous current of blue fluid cuts through the plane.  You need to screen your eyes from the radiating light to not become blinded. Even at this distance you feel the Flux" presence in your body, as if your atoms were spinning three times their normal pace. You don't know if it's a good idea to approach it further.

You can go east and south.

You can see an Unregulated Flux Current here.

>x current
A branch of the Flux.

>e
Landing Zone
Your crash site. You can go in all directions.

You can see Teleportation Stone - Kaldríss, Teleportation Stone - Frizza, Teleportation Stone - Geysiria, Teleportation Stone - Gaisetto, Teleportation Stone - Sitis and a Discharged Spaceship (in which is a Power Unit (empty)) here.

>w
Flux
The main Flux current of the region. A huge rock loosely stands at its shores.

You can go east and south.

You can see an Unregulated Flux Current here.

>s
Scoop (Settler's Base)
You see a part of the Flux winding through a fjord deep down. Above your level there are metal constructions, thrust into the rock, from where little transportation devices start to the blue current at the valley's bottom, each manned with two humanlike figures. Near the bridgelike scaffold (you think it may be the only way across the gap) you notice some cabins, tightly hugging the cliffs. It seems you could approach the nearest one.

You can go east  and west.

You can see a Cabin (empty) here.

>x cabin
The only one you can safely reach. One part of it seems to be solidly built into the rock, the other half protruding into the sheer abyss of the ravine. By the look of it you could swear that it will topple down the cliff any moment, but it holds. Inside you see a warm light and someone moving. You could try to approach.

>approch cabin
That's not a verb I recognise.

>approach cabin
You scramble over the ghastly landscape, keeping the ravine's edge to a good distance. You get an even better view of the structures that span the width of the gorge, you are now certain that there is mining equipment and transportation units, some manned and some apparently controlled remotely. You approach the cabin, saving a couple of steps in distance, and try to glance into the inside of the cabin. Someone sits there at a metal desk, wearing a hardhat and sunglasses, between ridiculous heaps of papers and files. In his mouth there is an oblong roll, glowing blue, and on one of the inside wall hangs an oversized metal suit, equipped with all kind of complex-looking gear. As you eyeball the scene, the man suddenly turns his head and straigthly spots you through his shaded glasses. He stands up opens a window, pointing in your direction. You see a broad smile stamped into his face.

Oi, mate! What ya doin" all by yaself out there? Ya ain't have no mischief in mind, do ya? Don't look like one of those blue Duju folk. What's ya name, mate?

The thick accent washes over you. Momentarily, you believe you smelled grilled meat ... you abandon the thought.

>answer name
(to Trapist)
There is no reply.

>look
Scoop (Settler's Base)
You see a part of the Flux winding through a fjord deep down. Above your level there are metal constructions, thrust into the rock, from where little transportation devices start to the blue current at the valley's bottom, each manned with two humanlike figures. Near the bridgelike scaffold (you think it may be the only way across the gap) you notice some cabins, tightly hugging the cliffs. It seems you could approach the nearest one.

You can go east  and west.

You can see a Cabin (in which is Trapist) here.

>e
Wasteland
A pitiful piece of land. Black sand, red rocks and some sickish looking plants. If you are not looking for something particular there is no need to linger. 

You can go west and north.

>w
Scoop (Settler's Base)
The main Flux working of the region. 

 You can go east and west.

You can see a Cabin (in which is Trapist) here.

>e
Wasteland
One of the dreary planes in the region.

You can go west and north.

>n
Landing Zone
Your crash site. You can go in all directions.

You can see Teleportation Stone - Kaldríss, Teleportation Stone - Frizza, Teleportation Stone - Geysiria, Teleportation Stone - Gaisetto, Teleportation Stone - Sitis and a Discharged Spaceship (in which is a Power Unit (empty)) here.

>s
Wasteland
One of the dreary planes in the region.

You can go west and north.

>w
Scoop (Settler's Base)
The main Flux working of the region. 

 You can go east and west.

You can see a Cabin (in which is Trapist) here.

>enter cabin
That's not something you can enter.

>x cabin
A small hut in which Trapist is working. There are heaps of paperwork, the faint glow of a light bulb and Trapist sitting in the midst of it, his face illuminated by his bluishly burning cigarette.

In the Cabin is Trapist.

>x trapist
A huge man with thick strands of muscle. His eyes are shaded by pitch black sunglasses, he wears an orange helmet under which a broad smile splits his mouth apart. Between the teeth he holds some sort of cigarette which seems to be fueled by Flux.

>ask trapist about my mother
Wait a second, why not introduce yourself first? You shy, mate? What's ya name?

>my name is axesto
That's not a verb I recognise.

>answer axesto
(to Trapist)
Strange name that. Ah well, I don't mind as long as you ain't starting to act funny. Mine's Trapist ... guess that sounds strange as well, I'm the foreman here. I guess it's back to work now, you certainly see that pile of misery on the desk there. Ain't no gain for no work. Let me now if y'all need something.

>answer no
(to Trapist)
There is no reply.

>look
Scoop (Settler's Base)
The main Flux working of the region. 

 You can go east and west.

You can see a Cabin (in which is Trapist) here.

>e
Wasteland
One of the dreary planes in the region.

You can go west and north.

>w
Scoop (Settler's Base)
The main Flux working of the region. 

 You can go east and west.

You can see a Cabin (in which is Trapist) here.

>ask trapist about power unit
There is no reply.

>w
There's no way you will get across the scaffold bridge unnoticed, better introduce yourself first.

>e
Wasteland
One of the dreary planes in the region.

You can go west and north.

* * *

>w
Scoop (Settler's Base)
The main Flux working of the region. 

 You can go east and west.

You can see a Cabin (in which is Trapist) here.

>s
The broad Flux of phosphorescent energy blocks your way.

>n
Flux
The main Flux current of the region. A huge rock loosely stands at its shores.

You can go east and south.

You can see an Unregulated Flux Current here.

>e
Landing Zone
Your crash site. You can go in all directions.

You can see Teleportation Stone - Kaldríss, Teleportation Stone - Frizza, Teleportation Stone - Geysiria, Teleportation Stone - Gaisetto, Teleportation Stone - Sitis and a Discharged Spaceship (in which is a Power Unit (empty)) here.

>s
Wasteland
One of the dreary planes in the region.

You can go west and north.

* * *

>w
Scoop (Settler's Base)
The main Flux working of the region. 

 You can go east and west.

You can see a Cabin (in which is Trapist) here.

>go to cabin
You can't see any such thing.

>x cabin
A small hut in which Trapist is working. There are heaps of paperwork, the faint glow of a light bulb and Trapist sitting in the midst of it, his face illuminated by his bluishly burning cigarette.

In the Cabin is Trapist.

* * *

>x trapist
A huge man with thick strands of muscle. His eyes are shaded by pitch black sunglasses, he wears an orange helmet under which a broad smile splits his mouth apart. Between the teeth he holds some sort of cigarette which seems to be fueled by Flux.

>ask trapist about flux
Now that's why we're all here. That slack goo gives yaself, ya family, ya neighbors and ya soot'n great-step-uncle money for a thousand years to come. One time lucky, never care about anything anymore. At least if we'd keep the profit. Damn tough mining that stuff though.

>ask about spaceship
You can't see any such thing.

>ask trapist about current
There is no reply.

>e
Wasteland
One of the dreary planes in the region.

You can go west and north.

* * *

>n
Landing Zone
Your crash site. You can go in all directions.

You can see Teleportation Stone - Kaldríss, Teleportation Stone - Frizza, Teleportation Stone - Geysiria, Teleportation Stone - Gaisetto, Teleportation Stone - Sitis and a Discharged Spaceship (in which is a Power Unit (empty)) here.

>w
Flux
The main Flux current of the region. A huge rock loosely stands at its shores.

You can go east and south.

You can see an Unregulated Flux Current here.

>x rock
A huge, slender rock looms at the shore of the Flux. It would make a good land to the Flux. It doesn't seem to stand all too stable, if you could only knock it over with something ...

>knock over rock
That's not a verb I recognise.

>knock rock over
That's not a verb I recognise.

>destroy rock
Violence isn't the answer to this one.

>take rock
You don't seem to be strong enough.

>s
Scoop (Settler's Base)
The main Flux working of the region. 

 You can go east and west.

You can see a Cabin (in which is Trapist) here.

>e
Wasteland
One of the dreary planes in the region.

You can go west and north.

* * *

>w
Scoop (Settler's Base)
The main Flux working of the region. 

 You can go east and west.

You can see a Cabin (in which is Trapist) here.

>w
There's no way you will get across the scaffold bridge unnoticed, better introduce yourself first.

>n
Flux
The main Flux current of the region. A huge rock loosely stands at its shores.

You can go east and south.

You can see an Unregulated Flux Current here.

* * *

>w
Flux
The main Flux current of the region. A huge rock loosely stands at its shores.

You can go east and south.

You can see an Unregulated Flux Current here.

>s
Scoop (Settler's Base)
The main Flux working of the region. 

 You can go east and west.

You can see a Cabin (in which is Trapist) here.

* * *

>w
Flux
The main Flux current of the region. A huge rock loosely stands at its shores.

You can go east and south.

You can see an Unregulated Flux Current here.

>e
Landing Zone
Your crash site. You can go in all directions.

You can see Teleportation Stone - Kaldríss, Teleportation Stone - Frizza, Teleportation Stone - Geysiria, Teleportation Stone - Gaisetto, Teleportation Stone - Sitis and a Discharged Spaceship (in which is a Power Unit (empty)) here.

>e
Ascent
The mountains are composed of stone in various shades of red and reach far to the sky. In between the cliffs and sheers you see a narrow path winding up. There is no clue on where it might lead, but you could find out.

You can go west and up.

>go up
You have the feeling of being watched. You wouldn't want to climb the cliffs if someone is around.

>west
Landing Zone
Your crash site. You can go in all directions.

You can see Teleportation Stone - Kaldríss, Teleportation Stone - Frizza, Teleportation Stone - Geysiria, Teleportation Stone - Gaisetto, Teleportation Stone - Sitis and a Discharged Spaceship (in which is a Power Unit (empty)) here.

>e
Ascent
The foot of the mountain. 

A narrow path leads upwards. You can also go west.

You can see Dunia here.

>look around
You can't see any such thing.

>x dunia
A lean but athletic figure, wrapped by several layers of what looks like tough leather. In a small gap of her hood you can see glinting eyes that reveal a sharp mind.

You are painfully near to trespass holy ground, stranger. I would advise against it. Who are you, anyway? You don't look like a Techie. Tell me your name.

>answer axesto
(to Dunia)
What a strange name. It doesn't matter anyway - there's only one thing I need to know: are you on the side of the Techies or of the Duju?

>techies
That's not a verb I recognise.

>asnwer techies
That's not a verb I recognise.

>answer techies
(to Dunia)
Then begone with you! I don't want anything to do with that!

>undo
Ascent
[Previous turn undone.]

>answer duju
(to Dunia)
Well then, that's not a bad way to start. Thinking about it - an outsider might be what we need. I'll introduce you to someone, and that is not an invitation.

 With seemingly little effort she climbs down the cliffs to your level, before insistently inviting you to come with her.
 Both of you walk through the scraggy landscape, her leading the way with distinct commands. Slowly you approach an archlike structure, close to one branch of the Flux. As you get nearer you perceive a couple of bulky shapes, guarding the entrance to the structure. Some hundred metes in front of the entrance your companion turns to you. 

Try not to look too provoking.

You know why while passing the guards: each and every one of them gazes at you. In consideration of the thick armour plates, the rather oversized guns and their radiating blue glow you refrain from making any quick motions.

Flux Gate
An archlike structure stands out against the vastness of the planes. As you approach you become aware of some figures in front of the structure. Strangely, it looks like they were glowing bluishly. At second glance they seem hardly human, you don't know how they will react to your appearance. 

You can go east.

Inside you find yourself in the midst of a small-sized hall, that doesn't appear to justify any of the expenditure you just encountered. In the back you spot an opening and a staircase, leading downwards. To the left there is a full board of controls and two figures unhastily operating them. You can't look around any more, as you are approached quickly by an impressive sized person, already bellowing a few direct words with a booming voice.

Dunia! Who is this? Explain yourself!

A guest of sorts. He stumbled about the Ascent when I found him. I don't think he's a Techie, at least he has a slightly better manners and he keeps his voice down to a sensible level when talking. Besides, I thought about his use in regard to certain issues, due to his undujulike appearance.

Both eyeball you thoroughly for what seems to you like hours. Eventually, the massive Duju makes a quick motion towards Dunia, indicating her to follow him. He shoots a last glance at you.

Don't let yourself be found sniffing around somewhere, it would not contribute to your wellbeing.

 They march off, disappearing into the opening at the end of the hall. You are not guarded, it seems like you could look around. Of course you could also do as you were told and wait.

>look
Flux Gate
An archlike structure stands out against the vastness of the planes. As you approach you become aware of some figures in front of the structure. Strangely, it looks like they were glowing bluishly. At second glance they seem hardly human, you don't know how they will react to your appearance. 

You can go east.

You can see a console, a weapon's rack (on which is a gun), Duju Operator 1 and Duju Operator 2 here.

>x console
A huge oval table, full of ... nothing, actually. All you see is a reflective surface, into which the operators dunk their hands, emitting small waves. Where they touch the surface, you believe to see tiny, interlinked pulses of blue light, like a neural system, but you can't be sure. 

As you study the console, the two operators become aware of you, freezing in their motion and watching you suspiciously.

Anyhow, you could examine the console further.

>x console
After taking a closer look, you make out that the energy of the Operators seems to be induced into the console. You start to see a pattern in the waves and currents of the reflective surface ... it reminds you of the great Flux currents ... 

As you continue to glance at the console, one of the operators pulls his hands out of it and stands up from his chair. Obviously you don't make a good impression by standing there, maybe it would be wise to say something or disengage from the console. Still, you could examine it further.

>x console
Before you can investigate further, the Operators suddenly burst out, chattering bright metallic sounds all over the hall. Instantly there are guards surrounding you, one of which quickly forces you to your knees and irresistibly renders you immobile with some sort of cuffs. You are carried to one corner of the hall like a very miserable sack of grain. Lying down, relaxing perforce, you await Dunia and Du'un to set you free.

>look
In your present condition, that's hardly possible.

>x weapon's rack
In your present condition, that's hardly possible.

>e
In your present condition, that's hardly possible.

>wait
You lie, waiting, contemplating your choices.

>wait
Still you lie, your eyes fixed in position due to the fact that your head is fixed as well.  As if that wasn't enough, your punishers turned you to a rather unexciting corner of the room.

>wait
Finally you hear steps approaching and a booming laughter.

A little snoopy, are we? Well, not the worst of traits. Hold still.

You hear clattering and feel your mobility returning. Stiffly you get up and see the two Duju standing before you. You think you recognize a bit of amusement in the eyes of the bigger one.

Don't worry, our guards are very cautious, and our Operators even more so, I am certain you meant no harm, if you would have, you wouldn't be here any more.

He hands you something that distantly reminds you of a fishing net, only is this one almost ridiculously overengineered. You must have a rather puzzled look to your face, as Du'un starts to explain soon after. 

That is a Flux Extractor, the Techies call them "Scoops". It is used to extract small portions of the Flux and isolate it for examination. If you want to help us out, showing us that you have no evil intent in the process, go and extract two samples of the Flux, one from the current before it passes through this gate, and one after it has done so. I am sure you will find the proper locations for this purpose yourself. When you are done or have any questions, return here, Dunia will be to your assistance.

You receive a Flux Extractor.

With that, Du'un goes off, quickly descending the stairs at the back of the hall. You are left with a vague task and Dunia, who doesn't look very pleased.

To your assitance, eh? Well, better than climbing that awful piece of a mountain, I suppose.

>ask dunia about flux extractor
She giggles a bit.

It is simple, you will see when you get to the Flux. Just dip it in.

She shows a devilish grin. Oh, but there's something I can help you with.

Suddenly Dunia grasps a corner of her leathery clothing and, with one swoosh, unwraps it from her body. Underneath, a sinewy, bluish body comes to appearance.

Here, take this, it will prevent the Flux from disintegrating you all too fast.

The devilish grin emerges again.

And stop staring.

You receive a Sinkan Cloak.

>x cloak
The leather is completely unfamiliar to you. With its wide span you would have expected it to weigh heavy, but it lies lightly in your arms, as if you were carrying only a blanket. There is a little Duju insignia on the back.

>x insignia
You can't see any such thing.

>look
Flux Gate
An archlike structure stands out against the vastness of the planes. As you approach you become aware of some figures in front of the structure. Strangely, it looks like they were glowing bluishly. At second glance they seem hardly human, you don't know how they will react to your appearance. 

You can go east.

You can see Dunia, a console, a weapon's rack (on which is a gun), Duju Operator 1 and Duju Operator 2 here.

>x weapon's rack
An ugly but pracitcal piece of furniture, made to store weaponry.

On the weapon's rack is a gun.

>x gun
An unfamiliar chunk of metal with a glowing core, you can barely identify it, except for the muzzle. Honestly, you wouldn't even know how to fire it.

>take gun
Until now you were considered peaceful. Taking a foreign gun in the middle of a foreign building could change that impression. Think good before taking it.